####################
#........w.........#
#..................#
#.....g.....b......#
#....z.......z.....#
#..................#
#.......B@B........#
####################